111111111111111111111111111111111111111111111111111111111111111111111111111111111111111111111111
110000000000000000000000000000000000000000000000000000000000000000000000000000000000000000000011
110000000000000000000000000000000000000000000000000000000000000000000000000000000000000000000011
110000000000000000000000000000000000000000000000000000000000000000000000000000000000000000000011
110000000000000000000000000000000000000000000000000000000000000000000000000000000000000000000011
110000001111111111111111110000000000111111111111111111111100000000001111111111111111111100000011
110000001100000000000000000000000000000000000000000000000000000000000000000000000000001100000011
110000001100000000000000000000000000000000000000000000000000000000000000000000000000001100000011
110000001100000000000000000000000000000000000000000000000000000000000000000000000000001100000011
110000001100000000000000000000000000000000000000000000000000000000000000000000000000001100000011
110000001100000000000000000000000000000000000000000000000000000000000000000000000000001100000011
110000000000000000000000000000000000000000000000000000000000000000000000000000000000000000000011
110000000000000000000000000000000000000000000000000000000000000000000000000000000000000000000011
110000000000000000000000000000000000000000000000000000000000000000000000000000000000000000000011
110000000000000000000000000000000000000000000000000000000000000000000000000000000000000000000011
110000000000000000000000000000000000000000000000000000000000000000000000000000000000000000000011
110000000000000000000000000000000000000000000000000000000000000000000000000000000000000000000011
110000001100000000000000000000000000000000000000000000000000000000000000000000000000001100000011
110000001100000000000000000000000000000000000000000000000000000000000000000000000000001100000011
110000001100000000000000000000000000000000000000000000000000000000000000000000000000001100000011
110000001100000000000000000000000000000000000000000000000000000000000000000000000000001100000011
110000001100000000000000000000000000000000000000000000000000000000000000000000000000001100000011
110000001111111111111111110000000000111111111111111111111100000000001111111111111111111100000011
110000000000000000000000000000000000000000000000000000000000000000000000000000000000000000000011
110000000000000000000000000000000000000000000000000000000000000000000000000000000000000000000011
110000000000000000000000000000000000000000000000000000000000000000000000000000000000000000000011
110000000000000000000000000000000000000000000000000000000000000000000000000000000000000000000011
111111111111111111111111111111111111111111111111111111111111111111111111111111111111111111111111
