111111111111111111111111111111111111111111111111111111111111111111111111111111111111111111111111
110000000000000000000000000000000000000000000000000000000000000000000000000000000000000000000011
110000000000000000000000000000000000000000000000000000000000000000000000000000000000000000000011
110000000000000000000000000000000000000000000000000000000000000000000000000000000000000000000011
110000000000000000000000000000000000000000000000000000000000000000000000000000000000000000000011
110000011111111111111111100000000001111111111111111111111100000000011111111111111111111100000011
110000011000000000000000000000000000000000000000000000000000000000000000000000000000001100000011
110000011000000000000000000000000000000000000000000000000000000000000000000000000000001100000011
110000011000000000000000000000000000000000000000000000000000000000000000000000000000001100000011
110000011000000000000000000000000000000000000000000000000000000000000000000000000000001100000011
110000011000000000000000000000000000000000000000000000000000000000000000000000000000001100000011
110000000000000000000000000000000000000000000000000000000000000000000000000000000000000000000011
110000000000000000000000000000000000000000000000000000000000000000000000000000000000000000000011
110000000000000000000000000000000000000000000000000000000000000000000000000000000000000000000011
110000000000000000000000000000000000000000000000000000000000000000000000000000000000000000000011
110000000000000000000000000000000000000000000000000000000000000000000000000000000000000000000011
110000000000000000000000000000000000000000000000000000000000000000000000000000000000000000000011
110000000000000000000000000000000000000000000000000000000000000000000000000000000000001100000011
110000011000000000000000000000000000000000000000000000000000000000000000000000000000001100000011
110000011000000000000000000000000000000000000000000000000000000000000000000000000000001100000011
110000011000000000000000000000000000000000000000000000000000000000000000000000000000001100000011
110000011000000000000000000000000000000000000000000000000000000000000000000000000000001100000011
110000011111111111111111111000000001111111111111111111111100000000011111111111111111111100000011
110000000000000000000000000000000000000000000000000000000000000000000000000000000000000000000011
110000000000000000000000000000000000000000000000000000000000000000000000000000000000000000000011
110000000000000000000000000000000000000000000000000000000000000000000000000000000000000000000011
110000000000000000000000000000000000000000000000000000000000000000000000000000000000000000000011
111111111111111111111111111111111111111111111111111111111111111111111111111111111111111111111111
