111111111111111111111111111111111111111111111111111111111111111111111111111111111111111111111111
110011000000000000000000000000000000000000000000000000000011001100000011000000110000000000000011
110011000000000000000000000000000000000000000000000000000011001100000011001100110011000000000011
110011000000111111111111110000110000111111111111111111111111001100110011001100110011000000000011
110011000000110000000000110000110000000000000000000000000000001100110000001100000011000000000011
110011000000110000000000110000110000111111111111111111000011001100111111111111111111001100110011
110011000000110000110000110000110000000000000000000000000011001100110000000000000000001100110011
110011111111110000110000110000110000111111111111111111111111001100110000000000000000001100110011
110000000000000000110000000000110000000000000000000000000011001100111111111111111111001100111111
110000000000000000110000000000110000000000000000000000000011001100110000000000000000001100111111
111111111111111111111111110000110000111111111111111111110011001100110000000000000000001100110011
110000000000000000000000110000110000110000000000000000110011001100111111111111111111001100110011
110011111111111111111100110000110000110000000000000000110000001100110000000000000000001100110011
110000000000000000000000110000110000110000000000000000110011001100110000000000000000001100110011
110011111111111111111100110000110000110000000000000000110011001100110000000000000000001100110011
110000000000000000000000110000000000110000000000000000110011000000000000000000000000000000000011
110011111111111111111111110000000000111111110000111111110011001111111111111111111111111111110011
110000000000000000000000110000110000000000000000000000000000001100000000000000000000000000000011
111111111111111111110000110000110000000000000000000000000000000000110011001111111111111111110011
110000000000000000000000110000110000111111111111111111111111111111111111001100000000000000000011
110000000000000000000000110000110000110000001100000000000000000000000000001100111111111111110011
110011111111111111111111110000110000110011001100110000111111111111111111001100110000000000000011
110000000000000000000000000000110000110011001100110000110000000000000011001100110011111111110011
110000000000000000000000000000110000110011001100110000110000110011000011001100110011000000000011
110000000001111111111111111111110000110011001100110000110000110011000011001100110011000000000011
110000000000000000000000000000000000110011000000110000111111110011111111001100110011000000000011
110000000000000000000000000000000000000011000000110000000000000000000000000000000000000000000011
111111111111111111111111111111111111111111111111111111111111111111111111111111111111111111111111