111111111111111111111111111111111111111111111111111111111111111111111111111111111111111111111111
110011000000000000000000000000000000000000000000000000000110011000000001100000011000000000000011
110011000000000000000000000000000000000000000000000000000110011000000001100000011000000000110011
110011000001111111111111111000011000011111111111111111111110011000110001100000011000011000110011
110011000001100000000000011000011000000000000000000000000000011000110000000000000000011000110011
110011000001100000000000011000011000011111111111111111100110011000111111111111111110011000110011
110011000001100001100000011000011000000000000000000000000110011000110000000000000000011000110011
110011111111100001100000011000011000011111111111111111111110011000110000000000000000011000110011
110000000000000001100000000000011000000000000000000000000110011000111111111111111110011000111111
110000000000000001100000000000011000000000000000000000000110011000110000000000000000011000111111
111111111111111111111111111000011000011111111111111111100110011000110000000000000000011000110011
110000000000000000000000011000011000011000000000000001100110011000111111111111111110011000110011
110001111111111111111000011000011000011000000000000001100000011000110000000000000000011000110011
110000000000000000000000011000011000011000000000000001100110011000110000000000000000011000110011
110001111111111111111000011000011000011000000000000001100110011000110000000000000000011000110011
110000000000000000000000011000000000011000000000000001100110000000000000000000000000000000000011
110001111111111111111111111000000000011111110000111111100110011111111111111111111111111111100011
110000000000000000000000011000011000000000000000000000000000001100000011000000000000000000000011
111111111111111111100000011000011000000000000000000000000000000000110000000111111111111111100011
110000000000000000000000011000011000011111111111111111111111111111111111000110000000000000000011
110000000000000000000000011000011000011000000110000000000000000000000000000110011111111111100011
110001111111111111111111111000011000011001100110011000111111111111111111000110011000000000000011
110000000000000000000000000000011000011001100110011000110000000000000011000110011001111111100011
110000000000000000000000000000011000011001100110011000110000110011000011000110011001100000000011
110001111111111111111111111111111000011001100110011000110000110011000011000110011001100000000011
110000000000000000000000000000000000011001100000011000111111110011111111000110011001100000000011
110000000000000000000000000000000000000001100000011000000000000000000000000000000000000000000011
111111111111111111111111111111111111111111111111111111111111111111111111111111111111111111111111
