111111111111111111111111111111111111111111111111111111111111000000000000000000000000000000000000
110000000000000000000000000000000000000000000000000000000011000000000000000000000000000000000000
110000111111111111000000110000110000110000001111111111000011000000000000000000000000000000000000
110000000000000000000000110000110000110000000000000000000011000000000000000000000000000000000000
110000111111111111000000110000110000110000001111111111000011000000000000000000000000000000000000
110000000000000000000000110000110000110000000000000000000011000000000000000000000000000000000000
110000000000000000000000000000000000000000000000000000000011000000000000000000000000000000000000
110000000000000000000000000000000000000000000000000000000011000000000000000000000000000000000000
110000000000000000000000000000000000000000000000000000000011000000000000000000000000000000000000
110000000000000000000000000000000000000000000000000000000011000000000000000000000000000000000000
110000000000000000000000000000000000000000000000000000000011000000000000000000000000000000000000
110000000000000000000000000000000000000000000000000000000011000000000000000000000000000000000000
110000000000000000000000110000110000110000000000000000000011000000000000000000000000000000000000
110000111111111111000000110000110000110000001111111111000011000000000000000000000000000000000000
110000000000000000000000110000110000110000000000000000000011000000000000000000000000000000000000
110000111111111111000000110000110000110000001111111111000011000000000000000000000000000000000000
110000000000000000000000000000000000000000000000000000000011000000000000000000000000000000000000
111111111111111111111111111111111111111111111111111111111111000000000000000000000000000000000000
000000000000000000000000000000000000000000000000000000000000000000000000000000000000000000000000
000000000000000000000000000000000000000000000000000000000000000000000000000000000000000000000000
000000000000000000000000000000000000000000000000000000000000000000000000000000000000000000000000
000000000000000000000000000000000000000000000000000000000000000000000000000000000000000000000000
000000000000000000000000000000000000000000000000000000000000000000000000000000000000000000000000
000000000000000000000000000000000000000000000000000000000000000000000000000000000000000000000000
000000000000000000000000000000000000000000000000000000000000000000000000000000000000000000000000
000000000000000000000000000000000000000000000000000000000000000000000000000000000000000000000000
000000000000000000000000000000000000000000000000000000000000000000000000000000000000000000000000
000000000000000000000000000000000000000000000000000000000000000000000000000000000000000000000000