111111111111111111111111111111111111111111111111111111111111000000000000000000000000000000000000
110011000000000000000000000000000000000000000000000000000011000000000000000000000000000000000000
110011000000000000000000000000000000000000000000000000000011000000000000000000000000000000000000
110011000000111111111111110000110000111111111111111111111111000000000000000000000000000000000000
110011000000110000000000110000110000000000000000000000000011000000000000000000000000000000000000
110011000000110000000000110000110000111111111111111111000011000000000000000000000000000000000000
110011000000110000110000110000110000000000000000000000000011000000000000000000000000000000000000
110011111111110000110000110000110000111111111111111111111111000000000000000000000000000000000000
110000000000000000110000000000110000000000000000000000000011000000000000000000000000000000000000
110000000000000000110000000000110000000000000000000000000011000000000000000000000000000000000000
111111111111111111111111110000110000111111111111111111110011000000000000000000000000000000000000
110000000000000000000000110000110000110000000000000000110011000000000000000000000000000000000000
110011111111111111111100110000110000000000000000000000110011000000000000000000000000000000000000
110000000000000000000000110000110000000000000000000000110011000000000000000000000000000000000000
110011111111111111111100110000110000000000000000000000110011000000000000000000000000000000000000
110000000000000000000000110000000000110000000000000000110011000000000000000000000000000000000000
111111111111111111111111111111111111111111111111111111111111000000000000000000000000000000000000
000000000000000000000000000000000000000000000000000000000000000000000000000000000000000000000000
000000000000000000000000000000000000000000000000000000000000000000000000000000000000000000000000
000000000000000000000000000000000000000000000000000000000000000000000000000000000000000000000000
000000000000000000000000000000000000000000000000000000000000000000000000000000000000000000000000
000000000000000000000000000000000000000000000000000000000000000000000000000000000000000000000000
000000000000000000000000000000000000000000000000000000000000000000000000000000000000000000000000
000000000000000000000000000000000000000000000000000000000000000000000000000000000000000000000000
000000000000000000000000000000000000000000000000000000000000000000000000000000000000000000000000
000000000000000000000000000000000000000000000000000000000000000000000000000000000000000000000000
000000000000000000000000000000000000000000000000000000000000000000000000000000000000000000000000
000000000000000000000000000000000000000000000000000000000000000000000000000000000000000000000000